11111111111
1C0CCC000E1
11011111111
1P0C0CXCCC1
11111111111