1111111111111111111111
1010001011101110101111
1010101111111111111011
10000X0P0X000000001111
1011101011111010111011
1111111011101010001011
100011101111101X111011
1010101011111110101011
1111111010001010111011
1000CX0C1010100X0000E1
1111111111111111111111