1111111111111
1X010001000C1
10010X00010C1
10010001000C1
100100110X0C1
1011X010000C1
1000011111001
1P0011E000001
1111111111111