111111111
1110E11C1
101001001
101001001
100X00001
100000001
111000001
1000C0001
101010101
100000001
110101001
100000001
11100C001
10X010001
100010101
10001C1X1
1C001C1C1
10C0C0C01
1X00C0001
111100001
10C00C001
100001111
1X00C00X1
101101101
101000101
101000101
1C11P01C1
111111111