11111111111
1C0000000E1
11111111111
1P0000000C1
11111111111